11111111111111111111111111111111111111111111111111
10P000C0000000000000000000000000000000000000000001
101000C0000000000000000000000000000000000000000001
101000C0000000000000000000000000000000000000000001
101000C0000000000000000000000000000000000000000001
101000C0000000000000000000000000000000000000000001
101000C0000000000000000000000000000000000000000001
101000C0000000000000000000000000000000000000000001
101000C0000000000000000000000000000000000000000001
101000C0000000000000000000000000000000000000000001
101000C0000000000000000000000000000000000000000001
101000C0000000000000000000000000000000000000000001
101000C0000000000000000000000000000000000000000001
101000C0000000000000000000000000000000000000000001
101000C0000000E00000000000000000000000000000000001
101000C0000000000000000000000000000000000000000001
11111111111111111111111111111111111111111111111111